####################################
#              #                   #
#  #############  #############   ##
#  #                #           # ##
#  #  #############  #########   # #
#  #  #              #       #     #
#  #  #  #############  #    #### ##
#  #o #           #  #  #       # ##
#  ####  ##########  #  ######  # ##
#     #           #  ##         # ##
#  #### ############  ##########  ##
#  #           #   #              ##
#  #  ########## ######   ##########
#  #  #              #        #   ##
#  #  #  #############   #   #   ###
#     #                    #   # ###
####################################