####################################
#        #         #   #   #      ##
#  #######  #  #############  ##   #
#  #        #           #     #  # #
#  #  #############  ###  ######## #
#  #  #              #        #    #
#  #  #  #######  #  ##### ## #    #
#  #  #        #  #  #        ##   #
#  #  ##########  #  #  ##### #### #
#  #              #     ##       # #
#  #############  #####  ######  # #
#         ##             ##      # #
#########  ############# #  ###### #
#                        ####      #
#  #############################   #
####################################