####################################
#             #      #             #
#  #######    #      #       #######
#  #     #    #    ######    #     #
## # ### #    #              # ### #
#  # ### #########  #######  # ### #
## # ### #    # ##  #     #  #     #
#   ############ ## #     #    # ###
#              # #  #     #   #  ###
############## # ## #     # ##   ###
#              # #  ### ### #    ###
# ############## ## ###   # #    ###
#              # #  ##### #      ###
############## # ## #####   ########
#                   # O            #
####################################